111111111111111111111111111111111111111111111111111111111111111111111
111111111111111111111111111111111111111111111111111111111111111111111
111111111111111111111111111111111111111111111111111111111111111111111
111111111111111111111111111111111111111111111111111111111111111111111
111111111111111111111111111111111111111121111111111111111111111111111
111111111111111111111111111111111111111202111111111111111111111111111
111111111111111111111111111111111111111121111111111111111111111111111
111111111111111111111111111111111111111111111111111111111111111111111
111111111111111111111111111111111111111111111111111111111111111111111
111111111111111111111111111111111111111111111111111111111111111111111
111111111111111111111111111111111111111111111111111111111111111111111
111111111111111111111111111111111111111111111111111111111111111111111
111111111111111111111111111111111111111111111111111111111111111111111
111111111111111111111111111111111111111111111111111111111111111111111
111111111111111111111111111111111111111111111111111111111111111111111
111111111211111111111111111111111111111111111111111111111111111111111
111111112022211111111111111111111111111111111111111111111111111111111
111111120000021111111111111111111111111111111111111111111111111111111
111111120000021111111111111111111111111111111111111111111111111111111
111111120000211111111111111111111111111111111111111111111111111111111
111111120000211111111111111111111111211111111111111111111111111111111
111111120000021111111111111111111112021111111111111111111111111111111
111111120000002111111111111111111111221111111111111111111111111111111
111111120000000211111111111111111111202111111111111111111111111111111
111111120000000021111211111111111111200211111211111111111111111111111
111111120000000002222022211111111111200022222021111111111121111111111
111111112222222000000000021111111111200000000002111111111202111111111
111111111111111200000000021111111111200000000000211111111120211111111
111111111111111200000000002111111111200000000000211111111120211111111
111111111111111200000000000211111111200000000000021111111120211111111
111111111111111122222000000211111111200000000000002111111112111111111
111111111111111111111200000211111111200000000000000211111111111111111
111111111111111111111200002111111111122000000000000211111111111111111
111111111111111111111200021111111111112000000022222111111111111111111
111111111111111111111200021111111111112000000211111111111111111111111
111111111111111111111200002111111111112000000021111111111111111111111
111111111111111111111200000211111111112000000021111111111111111111111
111111111111111111111200000021111111112000000002111111111111111111111
111111111111111111111200000002111111112000000002111111111111111111111
111111111111111111111200000000211111112000000002111111111111111111111
111111111111111111111200000000211111111222220002111111111111111111111
111111111111111111112000000000021111111111112221111111111111111111111
111111111111111111111200000000021111111111111111111111111111111111111
111111111111111111111122220000021111111111111111111111111111111111111
111111111111111111111111112000002111111111111111111111111111111111111
111111111111111111111111112000000211111111111111111111111111111111111
111111111211111111111111112000000021111111111111111111111111111111111
111111112021111111111111111200000002111111111111111111111111111111111
111111120002111111111111111200000000211111111111111111111111111111111
111111120000211111111111111122220000021111111111111111111111111111111
111111120000021111111111111111112000002111111111111111111111111111111
111111120000002111111111111111112000002111111111111111111111211111111
111111120022000211111111111111111222002111111111111111111112021111111
111111112211222122211111111111111112002111111111111111111112002211111
111111111111111200021111111111111112002111111111111111111120000021111
111111111111111200002222221111111112021111111111111111111200000002111
111111111111111200000000002111111111211111111111111111111200000002111
111111111111111200000000000211111111111111111111111111111200000002111
111111111111111122220000000021111111111111111111111111112000000021111
111111111111111111112222222002111111111111111111111111112000000211111
111111111111111111111111112002111111111111111111111111112000000211111
111111111111111111111111111221111111111111111111111111112000000021111
111111111111111111111111111111111111111111111111111111112000000021111
111111111112111111111111111111111111111111111111111111112000000021111
111111111120211111111111111111111111111111111111111111112000000021111
111111111120021111111111111111112211111111111111111111112000000021111
111111111120021111111111111111120022111111111111111111112000000021111
111111111112211111111111111111200000211111111111111111112000000021111
111111111111111111111111111111200000021111111111111111111222200211111
111111111211111111111111111111122000002111111111111111111111200211111
111111112021111111111111111111111200002111111111111111111111200211111
111111111211111111111111111111211200021111111111111111111111200211111
111111111111221111111111111112022002211111111111111111111112002111111
111111111112002221111111111112000021111111111111111111111112021111111
111111111111222002111111111112000211111111111111111111111111211111111
111111111111112000211111111112000211111111111111111111111111111111111
111111111111112002111111111112000211111111111111111111111111111111111
111111111111112021111111111112002111111111111111111111111111111111111
111111111111111211111111111111221111111111111111111111111111111111111
111111111111111111111111111111111111111111111111111111111111111111111
111111111111111111111111111111111111111111111111111111111111111111111
111111111111111111111111111111111111111111111111111111111111111111111
111111111111111111111111111111111111111111111111111111111111111111111
111111111111111111111111111111111111111111111111111111111111111111111
111111111111111111111111111111111111111111111111111111111111111111111
111111111111111111111111111111111111111111111111111111111111111111111
111111111111111111111111111111111111111111111111111111111111111111111
111111111111111111111111111111111111111111111111111111111111111111111
111111111111111111111111111111111111111111111111111111111111111111111
111111111111111111111111111111111111111111111111111111111111111111111
111111111111111111111111111111111111111111111111111111111111111111111
111111111111111111111111111111111111111111111111121111111111111111111
111111111111111111111111111111111111111111111111202111111111111111111
111111111111111111111111111111111111111111111112000211111111111111111
111111111111111111111111111111111111111111111120000021111111111111111
111111111111111111111111111111111111111111111112222211111111111111111
111111111111111111111111111111111111111111111111111111111111111111111
111111111111111111111111111111111111111111111111111111111111111111111
111111111111111111111111111111111111111111111111111111111111111111111
