1100011111
1001000011
1032111011
1030301011
1030301011
1012111011
1010000011
1000111111
1111111111