11111332002111111111
11111332002111111111
11111112002111111111
11111112002111111111
11111112002113331111
11111112002220021111
11111112000220021111
11111112200220021111
33311112200000221111
33331112200000211111
33331111200222211111
33331122202221111111
33311120002111111111
33111122222111111111
33111111111111111111
33111113331111111111
11111113300021111111
11111111100021111111
11111111110021111111
11111111112221111111