11111332112111111111
11111332112111111111
11111112112111111111
11111112112111111111
11111112112113331111
11111112112221121111
11111112111221121111
11111112211221121111
33311112211111221111
33331112211111211111
33331111211222211111
33331122212221111111
33311121112111111111
33111122222111111111
33111111111111111111
33111113331111111111
11111113311121111111
11111111111121111111
11111111111121111111
11111111112221111111